111111111111111111111
1E0C11111111111111111
101P11111111111111111
100011111111111111111
100011111111111111111
100011111111111111111
111111111111111111111